Word	Definition
berawan	cloudy
dingin	cold
derajat	degree (celcius)
kekeringan	drought
kering	dry
banjir	flood
kabut	fog
prakiraan	forecast
panas	hot
kilat	lightening
bmkg	meteorologist
lembab	moist, humid, damp
mendung	overcast
pelangi	rainbow
terik	scorching
musim	season
langit	sky
badai	storm
matahari	sun
cerah	sunny
keringat	sweat
suhu	temperature
petir	thunder
kepanasan	too hot
payung	umbrella
hangat	warm
cuaca	weather
basah	wet
hujan	wet weather, rain
angin	wind
berangin	windy
